标注	说明
SNP	SNP编号
CHR	染色体号
Position(hg19)	位点在hg19版本中的染色体上位置
Ref allele	位点在参照序列上的等位基因
Alt allele	位点的另一个等位基因
GeneName	基因名
Mrna	mRNA号
Region	在基因上的区域
CHBS_1000g	在1000genome中CHB和CHS中国人群中的频率
Total(11/01/00)	正常纯合(00)、杂合(01)、突变纯合(11)的所有样本数量
Total MAF	所有样本中最小等位基因频率
HWE	哈迪-温伯格平衡(Hardy-Weinberg equilibrium,HWE)的计算值（不区分case、control）
Case(11/01/00)	正常纯合(00)、杂合(01)、突变纯合(11)的Case样本数量
Case_refallele_number	Case样本参考Allele数量
Case_altallele_number	Case样本突变Allele数量
Case MAF	case样本中最小等位基因频率
HWE_Case	哈迪-温伯格平衡(Hardy-Weinberg equilibrium,HWE)的计算值（Case 样本）
Control(11/01/00)	正常纯合(00)、杂合(01)、突变纯合(11)的Control样本数量
Control_refallele_number	Control样本参考Allele数量
Control_altallele_number	Control样本突变Allele数量
Control MAF	control样本中最小等位基因频率
HWE_Control	哈迪-温伯格平衡(Hardy-Weinberg equilibrium,HWE)的计算值（Control 样本）
